9 7
WWWWWWWWW
W W     W
W    WWWW
W W  WE W
W W  WW W
WSW     W
WWWWWWWWW
