12 7
WWWWWWWWWWWW
W          W
WWW  WWWWW W
W    WS    W
W W  WWWWW W
WGWE       W
WWWWWWWWWWWW