5 6
WWWWW
WG  W
W W W
W WSW
WE  W
WWWWW